11111111111111111111111111
1P000000000000000000000001
1010001000CC011111110001C1
1010001000CC000000010001C1
1011111110CC001111110001C1
1000001000CC010000000001C1
1000011100CC011111110001C1
100000000000000000000001E1
11111111111111111111111111