1111111111111111111111111
1E0000000C00C000000000001
1010101100011010000010101
1010010011101010100010101
1P0000000C00C0000000000C1
1111111111111111111111111