111111111111111111
1P0000100E0C1110C1
1000010000010C0101
100C10000000000101
1001C0100000001001
101111110000010001
10000C1000001C0001
100000100001111101
100000000C00000001
111111111111111111