111111
11C111
111111
1P11E1
111111