11111111111111111111
1P1E0010000100000001
101000100001001100C1
10100010000111110001
10100010000111000011


1010C000000110C01111
10111110000100011111
10111110000100000001
10111111110111111101
100000C0000000000001
11111111111111111111
