1111111111111
1P010000000C1
1000011111001
1000110000E00
1111111111111