111111111111
1P000EC00001
111111111111