1111111111111
10010100001C1
1000011011111
1P0011E000001
1111111111111