111111
1PC0E1
100001
100001
100001
111111