1111111111111
1001000000000C1
1000011111001
100011E00000001
1111111111111