1111111111111
10010000P00C1
10M0011111001
100011E000001
1111111111111