111111111111111111
1P0000100E0C1110C1
1000010000010C0101
100C10000M00000101
10M1C0100000001001
101111110000M100M1
10000C1000001C0001
100000100001111101
10M000000C0000M001
111111111111111111